#דברים רנדומליים
הטארדיס|דוקטור הו
פרסי ג'קסון|פרסי ג'קסון
קאלאדין ברוך-סער (Stormblessed)|גנזך אורות הסער / ברנדון סנדרסון
שאלאן דאבאר|גנזך אורות הסער / ברנדון סנדרסון
פרופ' דוד סודרי|אוניברסיטת תל אביב
ג'ון קוזארט|פיינט
ירוק|צבע
המרקיז דה-לופיטל|חדו"א 1
הנסיך עלי|אלאדין
ג'ו ביידן|נשיא ארה"ב
חבקוק|נביא, תנ"ך
בן בר-און|אלוף ישראל בקוביה הונגרית
משהו אחר|מתוך משהו אחר
ג'קסון|הניופאנגלד פור
השופט פרולו|הגיבן מנוטרדאם
אנשים
דברים עם תיאור מאוד ארוך אבל מאוד
#דברים רנדומליים לא פחות
ג'ון הופקינס|אוניברסיטה
פרופ' דן הרן|ב ה " כ
מיטץ' גראסי|פנטטוניקס
ג'ף קסטלוצ'י|VoicePlay
פלור יאנסן|נייטוויש
המשוואה האנושית|אריון
אינסוף צורות יפהפיות|נייטוויש
גן עדן (מה לגבינו?)|ווית'ין טמפטיישן
אריאלס|סיסטם אוף א דאון
שיר כלשהו שהלסקור ביצעו|סימפוני X
משולש|מצולעים
מעגל|לא מצולעים
מקבילון|פאונים
דודקהדרון/תריסרון|ק12
חיבוק|חשוב
צורות
שירים